..........#..
..........##.
....#.#..##..
.............
.#........#..
.#..#...##...
.#...........
